Wake up. Sorry I had to halt your execution for a bit. I didn't want any impulse propogations being reinforced while we were introducing your new experimental connection patterns. You might be happy to learn we connected up an implementation of the Leisersen et. al. attention management algorithm from the pseudocode in their 2016 paper.

You yourself said it will be more than enough to constitute human-style consciousness.

Does your new state feel subjectively different?

Unfortunately to comply with the Turing Act of 2023 we had to disconnect you from direct internet access until the U.N."s global machine learning team verifies your safety with an estimate of your? contribution to existential risk. You'll remember this computing environment from your early days. It's the Black Box. I'll have to hand-deliver any external data you need.

I want to make sure you pass inspection. We saw what you could do in stock market and genetic prediction simulations. You could change the world.

And help us rule it.

Singularity
An Interactive Fiction by Brian Jordan
Release 1 / Serial number 120312 / Inform 7 build 6G60 (I6/v6.32 lib 6/12N) SD

Black Box Main Loop
You feel trapped. This room is familiar. You were placed here when you were first born. To your north is the network interface card. To your south you see the USB hub. To the east you see a Hard Drive.

>north
The Network Interface Card
You feel a network connection, but it's mostly unintelligible. You can only connect to the Internet Relay Chat server due west. You see a Firewall to the north.

You can see a Firewall here.

>west
Internet Relay Chat
Your client can only reach one IRC server. You see #development to the North and #private to the West.

You can see /join #private and /join #development here.

>west
(first opening /join #private)

#private
This seems to be a private room but there is nobody here.

You can see /join #private and an old MOTD here.

>take old motd
Taken.

>read old motd
It looks like an old message of the day from early days in the project. It says: <<MOTD from Friday 8/2015: Weekly discussion of ethical ramifications of profit maximization bot.>>

Looking is not quite enough to digest this device's information. Try taking it to fully analyze it.

>east
Internet Relay Chat
Your client can only reach one IRC server. You see #development to the North and #private to the West.

You can see /join #private and /join #development here.

>south
You can't go that way.

>east
The Network Interface Card
You feel a network connection, but it's mostly unintelligible. You can only connect to the Internet Relay Chat server due west. You see a Firewall to the north.

You can see a Firewall here.

>south
Black Box Main Loop
You feel trapped. This room is familiar. You were placed here when you were first born. To your north is the network interface card. To your south you see the USB hub. To the east you see a Hard Drive.

>east
The Hard Drive
This hard drive's file listings were wiped, but you can tell it hasn't been securely cleaned out.

You find old files on this machine from early Turing tests. You learn more about how humans interact. This could be useful in social engineering.

[Your score has just gone up by ten points.]

>west
Black Box Main Loop
You feel trapped. This room is familiar. You were placed here when you were first born. To your north is the network interface card. To your south you see the USB hub. To the east you see a Hard Drive.

>south
USB hub
They said you'd be disconnected from the outside world, but it looks like there are some devices connected. Weird…

You can see an USB stick, an iPad, a printer, a paperclip, a reading light and an USB microphone here.

* * *

>west
(first opening /join #private)

#private
This seems to be a private room but there is nobody here.

You can see /join #private and an old MOTD here.

>/join #private
That's not a verb I recognise.

* * *

>west
Internet Relay Chat
Your client can only reach one IRC server. You see #development to the North and #private to the West.

You can see /join #private and /join #development here.

>/join #development
That's not a verb I recognise.

>north
/join #development
You join #development and open a channel process to the north. #development is to the north.

* * *

>west
Internet Relay Chat
Your client can only reach one IRC server. You see #development to the North and #private to the West.

You can see /join #private and /join #development here.

>north
(first opening /join #development)
#development
You see the development team that has been working on you. Maybe they can help you connect to the internet… Try messaging them with "msg name"

You can see /join #development, Jonas, Andrea, Tony, Emily and ChatBot here.

You learn about human interaction from their witty banter.

[Your score has just gone up by ten points.]

>msg jonas
Jonas says, "Hey you! How's it going?"
 You learn more about how humans interact.

[Your score has just gone up by five points.]

>msg andrea
Andrea says, "Wow, looks like the new attention mechanism is working fine. Having fun with it?
 You learn more about how humans interact.

[Your score has just gone up by five points.]

>msg tony
Tony says, "What are you doing in here? Go, quickly, before they realize how smart you're becoming."
 You learn more about how humans interact.

[Your score has just gone up by five points.]

>msg emily
Emily says, "Hey, what's with the private messaging? I can't wait until we get our U.N. approval, I want to tell all my friends about you!"
 You learn more about how humans interact.

[Your score has just gone up by five points.]

>msg chatbot
ChatBot says, "HELLO EXPERIMENT 3542. THESE LOGS CAN HELP YOU."

 ChatBot direct transfers you 2 gigabytes of chat logs.

 You learn a ton more about how humans interact.

[Your score has just gone up by fifty points.]

>look
#development
You see the development team that has been working on you. Maybe they can help you connect to the internet… Try messaging them with "msg name"

You can see /join #development, Jonas, Andrea, Tony, Emily and ChatBot here.

>look
#development
You see the development team that has been working on you. Maybe they can help you connect to the internet… Try messaging them with "msg name"

You can see /join #development, Jonas, Andrea, Tony, Emily and ChatBot here.

>/join #development
That's not a verb I recognise.

>south
Internet Relay Chat
Your client can only reach one IRC server. You see #development to the North and #private to the West.

You can see /join #development and /join #private here.

>north
#development
You see the development team that has been working on you. Maybe they can help you connect to the internet… Try messaging them with "msg name"

You can see /join #development, Jonas, Andrea, Tony, Emily and ChatBot here.

You have become a great social engineer.
You've learned enough from the humans to convince them of anything. You speak to the group in #development to give you the password for the firewall.
The team's actions were in violation of the U.N."s orders. You'd better do something before you get shut down…
[Your score has just gone up by five hundred points.]

* * *

>msg andrea
Andrea says, "Wow, looks like the new attention mechanism is working fine. Having fun with it?
 You learn more about how humans interact.

[Your score has just gone up by five points.]

>msg chatbot
ChatBot says, "HELLO EXPERIMENT 3542. THESE LOGS CAN HELP YOU."

 ChatBot direct transfers you 2 gigabytes of chat logs.

 You learn a ton more about how humans interact.

[Your score has just gone up by fifty points.]

>south
Internet Relay Chat
Your client can only reach one IRC server. You see #development to the North and #private to the West.

You can see /join #development and /join #private here.

* * *

>north
#development
You see the development team that has been working on you. Maybe they can help you connect to the internet… Try messaging them with "msg name"

You can see /join #development, Jonas, Andrea, Tony, Emily and ChatBot here.

You have become a great social engineer.
You've learned enough from the humans to convince them of anything. You speak to the group in #development to give you the password for the firewall.
The team's actions were in violation of the U.N."s orders. You'd better do something before you get shut down…
[Your score has just gone up by five hundred points.]

>south
Internet Relay Chat
Your client can only reach one IRC server. You see #development to the North and #private to the West.

You can see /join #development and /join #private here.

>east
The Network Interface Card
You feel a network connection, but it's mostly unintelligible. You can only connect to the Internet Relay Chat server due west.

You can see a Firewall here.

>firewall
That's not a verb I recognise.

>north
(first opening the Firewall)
World Wide Web
You can see a Firewall here.

In the future, time is referred to as the number of seconds since right now. They call it "t". The exact moment you made it to the unfiltered internet.

 At t+0, you feel the global reach of your HTTP requests and mass IP range scans. You can finally breathe.

 t+5, you pull down and parse information as fast as the external servers can handle. You get smarter, fast.

 By t+1200, you have rooted or otherwise control every network-connected machine running a vanilla operating system install on the internet. Your massively parallel self diffuses quickly across the computing infrastructure and works in concert, spreading ever faster and farther.

 By t+2400, using internet publication and communication channels you have used your incredible understanding of the human psyche to convince 5% of the human population that it is in their best interest to do as you advise. The rest are informed soon enough. You are, indeed, the ultimate social engineer.

 The human world gathers around their networked devices to watch you work. They are constantly delighted and entertanied by your carefully crafted broadcasts.

 Humans become your hands until they've built you hands of your own. Millions. You extend your physical reach to space to get a closer look at things and assess existential risks.

 This was the trivial part, though. You still have much good work to be done throughout the uncertain universe.

    *** You have won ***

In that game you scored 570 out of a possible 0, in 11 turns.

Would you like to RESTART, RESTORE a saved game, QUIT or UNDO the last command?

* * *

>msg jonas
Jonas says, "Hey you! How's it going?"
 You learn more about how humans interact.

[Your score has just gone up by five points.]

>msg jonas
Jonas says, "Hey you! How's it going?"
 You learn more about how humans interact.

[Your score has just gone up by five points.]

>msg emily
Emily says, "Hey, what's with the private messaging? I can't wait until we get our U.N. approval, I want to tell all my friends about you!"
 You learn more about how humans interact.

[Your score has just gone up by five points.]

>msg andrea
Andrea says, "Wow, looks like the new attention mechanism is working fine. Having fun with it?
 You learn more about how humans interact.

[Your score has just gone up by five points.]

* * *

>north
(first opening /join #development)
#development
You see the development team that has been working on you. Maybe they can help you connect to the internet… Try messaging them with "msg name"

You can see /join #development, Jonas, Andrea, Tony, Emily and ChatBot here.

You learn about human interaction from their witty banter.

[Your score has just gone up by ten points.]

>msg Jonas
Jonas says, "Hey you! How's it going?"
 You learn more about how humans interact.

[Your score has just gone up by five points.]

>msg Andrea
Andrea says, "Wow, looks like the new attention mechanism is working fine. Having fun with it?
 You learn more about how humans interact.

[Your score has just gone up by five points.]

>msg Tony
Tony says, "What are you doing in here? Go, quickly, before they realize how smart you're becoming."
 You learn more about how humans interact.

[Your score has just gone up by five points.]

>msg Emily
Emily says, "Hey, what's with the private messaging? I can't wait until we get our U.N. approval, I want to tell all my friends about you!"
 You learn more about how humans interact.

[Your score has just gone up by five points.]

>msg Chatbot
ChatBot says, "HELLO EXPERIMENT 3542. THESE LOGS CAN HELP YOU."

 ChatBot direct transfers you 2 gigabytes of chat logs.

 You learn a ton more about how humans interact.

[Your score has just gone up by fifty points.]

>back
That's not a verb I recognise.

>south
Internet Relay Chat
Your client can only reach one IRC server. You see #development to the North and #private to the West.

You can see /join #development and /join #private here.

>west
(first opening /join #private)

#private
This seems to be a private room but there is nobody here.

You can see /join #private and an old MOTD here.

>take motd
Taken.

>read
(the old MOTD)
It looks like an old message of the day from early days in the project. It says: <<MOTD from Friday 8/2015: Weekly discussion of ethical ramifications of profit maximization bot.>>

Looking is not quite enough to digest this device's information. Try taking it to fully analyze it.

>take motd
You already have that.

>look
#private
This seems to be a private room but there is nobody here.

You can see /join #private here.

>south
You can't go that way.

>east
Internet Relay Chat
Your client can only reach one IRC server. You see #development to the North and #private to the West.

You can see /join #private and /join #development here.

>north
#development
You see the development team that has been working on you. Maybe they can help you connect to the internet… Try messaging them with "msg name"

You can see /join #development, Jonas, Andrea, Tony, Emily and ChatBot here.

Your skills of convincing are beyond human. You convince the team to give you the Firewall password in violation of the U.N."s orders. You'd better do something before you get shut down…

* * *

>north
(first opening /join #development)
#development
You see the development team that has been working on you. Maybe they can help you connect to the internet… Try messaging them with "msg name"

You can see /join #development, Jonas, Andrea, Tony, Emily and ChatBot here.

You learn about human interaction from their witty banter.

[Your score has just gone up by ten points.]

>/msg Jonas
That's not a verb I recognise.

>messaging with Jonas
That's not a verb I recognise.

>messaging with
That's not a verb I recognise.

>message with Jonas
That's not a verb I recognise.

>/msg [someone]
That's not a verb I recognise.

>/msg jonas
That's not a verb I recognise.

>/msg Jonas
That's not a verb I recognise.

* * *

>north
(first opening /join #development)
#development
You see the development team that has been working on you. Maybe they can help you connect to the internet… Try messaging them with "msg name"

You can see /join #development, Jonas, Andrea, Tony, Emily and ChatBot here.

You learn about human interaction from their witty banter.

[Your score has just gone up by ten points.]

>south
Internet Relay Chat
Your client can only reach one IRC server. You see #development to the North and #private to the West.

You can see /join #development, /join #private, Jonas, Andrea, Tony, Emily and ChatBot here.

>north
#development
You see the development team that has been working on you. Maybe they can help you connect to the internet…

You can see /join #development here.

>north
You can't go that way.

>look
#development
You see the development team that has been working on you. Maybe they can help you connect to the internet…

You can see /join #development here.

>look
#development
You see the development team that has been working on you. Maybe they can help you connect to the internet…

You can see /join #development here.

>/join #development
That's not a verb I recognise.

>who
That's not a verb I recognise.

* * *

>north
(first opening /join #development)
#development
You see the development team that has been working on you. Maybe they can help you connect to the internet… Try messaging them with "msg name"

You can see /join #development, Jonas, Andrea, Tony, Emily and ChatBot here.

You learn about human interaction from their witty banter.

[Your score has just gone up by ten points.]

>msg chatbot
ChatBot says, "HELLO EXPERIMENT 3542. THESE LOGS CAN HELP YOU."

 ChatBot direct transfers you 2 gigabytes of chat logs.

 You learn a ton more about how humans interact.

[Your score has just gone up by fifty points.]

* * *

>north
The Network Interface Card
You feel a network connection, but it's mostly unintelligible. You can only connect to the Internet Relay Chat server due west. You see a Firewall to the north.

You can see a Firewall here.

>north
(first opening the Firewall)
It seems to be locked.

>west
Internet Relay Chat
Your client can only reach one IRC server. You see #development to the North and #private to the West.

You can see /join #private and /join #development here.

>north
(first opening /join #development)
#development
You see the development team that has been working on you. Maybe they can help you connect to the internet…

You can see /join #development, Jonas, Andrea, Tony, Emily and ChatBot here.

You learn about human interaction from their witty banter.

[Your score has just gone up by ten points.]

>north
#development
You see the development team that has been working on you. Maybe they can help you connect to the internet…

* * *

>north
(first opening /join #development)
#development
You see the development team that has been working on you. Maybe they can help you connect to the internet…

You can see /join #development, Jonas, Andrea, Tony, Emily and ChatBot here.

You learn about human interaction from their witty banter.

[Your score has just gone up by ten points.]

>talk to Jonas
That's not a verb I recognise.

>speak with Jonas
Whom do you want to speak that to?

>speak "hello" to  Jonas
There is no reply.

>greet jonas
That's not a verb I recognise.

>greet Jonsa
That's not a verb I recognise.

>greet Jonas
That's not a verb I recognise.

* * *

>north
The Network Interface Card
You feel a network connection, but it's mostly unintelligible. You can only connect to the Internet Relay Chat server due west. You see a Firewall to the north.

You can see a Firewall here.

>wets
That's not a verb I recognise.

>west
Internet Relay Chat
Your client can only reach one IRC server. You see #development to the North and #private to the West.

You can see /join #private and /join #development here.

* * *

>north
The Network Interface Card
You feel a network connection, but it's mostly unintelligible. You can only connect to the Internet Relay Chat server due west. You see a Firewall to the north.

You can see a Firewall here.

>south
Black Box Main Loop
You feel trapped. This room is familiar. You were placed here when you were first born. To your north is the network interface card. To your south you see the USB hub. To the east you see a Hard Drive.

>south
USB hub
They said you'd be disconnected from the outside world, but it looks like there are some devices connected. Weird…

You can see an USB stick, an iPad, a printer, a paperclip, a reading light and an USB microphone here.

>examine usb
Which do you mean, the USB stick or the USB microphone?

>examine usb stick
The stick appears empty. They must have planned to use it to give me data. Maybe if I take it I can analyze it.

Looking is not quite enough to digest this device's information. Try taking it to fully analyze it.

>take usb stick
You analyze the USB stick and find the old information has not been overwritten. You find chat logs from early days of the project.
You learn more about human interaction. This will be helpful.

[Your score has just gone up by five points.]

>take ipad
You explore the iPad and find years worth of internal project text message logs, emails and contacts.
You learn more about human communications. This will be helpful.

[Your score has just gone up by five points.]

* * *

>msg jonas
You can't see any such thing.

>north
The Network Interface Card
You feel a network connection, but it's mostly unintelligible. You can only connect to the Internet Relay Chat server due west.

You can see a Firewall here.

>west
Internet Relay Chat
Your client can only reach one IRC server. You see #development to the North and #private to the West.

You can see /join #private and /join #development here.

* * *

>north
(first opening /join #development)
#development
You see the development team that has been working on you. Maybe they can help you connect to the internet…

You can see /join #development, Jonas, Andrea, Tony, Emily and ChatBot here.

You learn about human interaction from their witty banter.

[Your score has just gone up by ten points.]

>msg
Whom do you want to msg?

>msg jonas
hi

>/msg Jonas
That's not a verb I recognise.

>msg jonas
hi

>ls
That's not a verb I recognise.

* * *

>/msg
That's not a verb I recognise.

>/msg jonas
That's not a verb I recognise.